10
2
What do you 
wish for?
confetti
confetti
confetti
PP                                                                                          
PP                                  T                                                       
PP                          SSSSSSSSSSSSSS                                                  
PP                           |          |                                                   
PP                           |          |                                                   
PP                  CCCCTCCC |CCCCTCCCC |                                                   
PP               SSSSSSSSSSSSSSSSSSSSSSSSS                                                  
PP                |          |          |                                                   
PP                |          |          |                                                   
PP    _  T        |     T    |    T     |      T          T                g                
PPPPPPPPPPPPPPPPPPPPPPPPPPPPPPPPPPPPPPPPPPPPPPPPPPPPPPPPPPPPPPPPPPPPPPPPPPPPPPPPPPPPPPPPPPPP
PPPPPPPPPPPPPPPPPPPPPPPPPPPPPPPPPPPPPPPPPPPPPPPPPPPPPPPPPPPPPPPPPPPPPPPPPPPPPPPPPPPPPPPPPPPP
PPPPPPPPPPPPPPPPPPPPPPPPPPPPPPPPPPPPPPPPPPPPPPPPPPPPPPPPPPPPPPPPPPPPPPPPPPPPPPPPPPPPPPPPPPPP
