8
2
What do you
desire?
confetti
doublejump
amsimon
                                                                                                                                            
                                                                                                                                            
                              C              T                                                                                              
                            SSSSS           SSS        T                                                                                    
                            |   |                     SSSSSSSSSSSSSSSSSSS  O                                                                
                            |   |    T             SSSS   |             PPPPPPPPPPP  T                                       C              
                           SSSSSSSSSSSSSSSS               |               PPPPPPPPPPPPPP                                 SSSSSSSSS          
               SSSSSSSS     |        W  |                 |                     PPPPPPPPPP                                |     |           
                |    |      |           |                 |                      PPPPPPPPPP   PPP                         |     |           
       _    T   |    |      |           |                 |     T            C PPPPPPPPPPPP   PPPP    T           g       |     |           
PPPPPPPPPPPPPPPPPPPPPPPPPPPPPPPPPPPPPPPPPPPPPPP        PPPPPPPPPPPPPPPPPPPPPPPPPPPPPPPPPPPP^^^PPPPPPPPPPPPPPPPPPPPPPPPPPPPPPPPPPPPPPPPPPPPPP
PPPPPPPPPPPPPPPPPPPPPPPPPPPPPPPPPPPPPPPPPPPPPPP        PPPPPPPPPPPPPPPPPPPPPPPPPPPPPPPPPPPPPPPPPPPPPPPPPPPPPPPPPPPPPPPPPPPPPPPPPPPPPPPPPPPPP
PPPPPPPPPPPPPPPPPPPPPPPPPPPPPPPPPPPPPPPPPPPPPPP        PPPPPPPPPPPPPPPPPPPPPPPPPPPPPPPPPPPPPPPPPPPPPPPPPPPPPPPPPPPPPPPPPPPPPPPPPPPPPPPPPPPPP
PPPPPPPPPPPPPPPPPPPPPPPPPPPPPPPPPPPPPPPPPPPPPPP     PPPPPPPPPPPPPPPPPPPPPPPPPPPPPPPPPPPPPPPPPPPPPPPPPPPPPPPPPPPPPPPPPPPPPPPPPPPPPPPPPPPPPPPP