10
2
What do you 
wish for?
lowgravity
goldknife
regen
                                                                                                                                        SS 
                                                                                                                                        SS 
                                                                                                                                        SS 
                                                                                                                                        SS 
                                                                                                                                        SS 
                                                                                                                                        SS 
                                                                                                              S            C            SS 
     G                                           S  C  S                                                      W            S            SS 
    SSSS                                         SSSSSSS                                                                ^^^^^^^         SS 
                   SSSSS                                                                                    S           SSSSSSS         SS 
 _                             SSSSSS                                                                 S                                 SS 
PPPPPPPPPPPPPP                                                SSSSSSSSS    O    SSSS                                                    SS 
PPPPPPPPPPPPPP                                   SSSSSSSS     SSSSSSSSSSSSSSSSSSSSSS           SSS                                      W  
PPPPPPPPP                                     S  SSSSSSSS                                                                                  
PP                                       SSS                                           S^^                S......S                         
PP                                   SSS                                               SSS                SSSSSSSS     ^    ^              
PP C        ^^        PPPPP                                                                         SS               SSSSSSSSSSSSS         
PPPPPPPPPPPPPP        PPPPP                         SS                                       SSSS                                          
                                                             ^ ^                                                                        SS 
                                                 ^ ^         SSS            C            S                                              SS 
                                                 SSS                        S                                                           SS 
