10
2
What do you 
wish for?
tophat
spikeimmune
fasterrunning
                                                                                                                        
                                                                                                                        
                                                                                                                        
                                C    S                                                                                  
                               SSS   S                                                                                  
                                     S                                                                                  
                                               C                                                                        
                                               SSSSSSSSSSSS                                      PP                     
                     SSSSSSS                   |     W |                           T              PPPPPP                
                 SSSS                          |       |             T     PPPPPPPPPPPPPPP                              
 _    T                                        | T   T |        PPPPPPPPPPPPPPPPPPPPPPPPPPP                 T           
PPPPPPP                           T       g PPPSSSSSSSSSPPPPPPPPPPPPPPPPPPPPPPPPPPPPPP           PPPPPPPPPPPPPPPPPPPPPPP
PPPPPPPPPP                O       PPPPPPPPPPPPPPPPPPPPPPPPPPPPPPPPPPPPPPPPPPPPPPPPPP            PPPPPPPPPPPPPPPPPPPPPPPP
PPPPPPPPPPPPPPPPPPPPPPPPPPPPPPPPPPPPPPPPPPPPPPPPPPPPPPPPPPPPPPPPPPPPPPPPPPPPPP             T     PPPPPPPPPPPPPPPPPPPPPPP
PPPPPPPPPPPPPPPPPPPPPPPPPPPPPPPPPPPPPPPPPPPPPPPPPPPPPPPPPPPPPP W                        ^^^PPP         PPPPPPPPPPPPPPPPP
PPPPPPPPPPPPPPPPPPPPPPPPPPPPPPPPPPPPPPPPPPPPPPPPPPPPPPPPP                              PPPPPPPP                      PPP
PPPPPPPPPPPPPPPPPPPPPPPPPPPPPPPPPPPPPPPPPPPPPPPPPPPPPPPPPP                       T   PPPPPPPPPPPPP T             T   PPP
PPPPPPPPPPPPPPPPPPPPPPPPPPPPPPPPPPPPPPPPPPPPPPPPPPPPPPPPPPPPPPC   T            PPPPPPPPPPPPPPPPPPPPPPP    O  PPPPPPP^PPP
PPPPPPPPPPPPPPPPPPPPPPPPPPPPPPPPPPPPPPPPPPPPPPPPPPPPPPPPPPPPPPPPPPPPPPPPPPPPPPPPPPPPPPPPPPPPPPPPPPPPPPPPPPPPPPPPPPPPPPPP
PPPPPPPPPPPPPPPPPPPPPPPPPPPPPPPPPPPPPPPPPPPPPPPPPPPPPPPPPPPPPPPPPPPPPPPPPPPPPPPPPPPPPPPPPPPPPPPPPPPPPPPPPPPPPPPPPPPPPPPP