8
2
What do you
desire?
confetti
doublejump
amsimon
                                                                                                                                            p
                                                                                                                                            p
                              C              T                                                                                              p
                            SSSSS           SSS        T                                                                                    p
                            |   |                     SSSSSSSSSSSSSSSSSSS  O                                                                 p
                            |   |    T             SSSS   |             PPPPPPPPPPP  T                                       C              p
                           SSSSSSSSSSSSSSSS               |               PPPPPPPPPPPPPP                                 SSSSSSSSS          p
               SSSSSSSS     |        W  |                 |                     PPPPPPPPPP                                |     |           p
                |    |      |           |                 |                      PPPPPPPPPP   PPP                         |     |           p
       _    T   |    |      |           |                 |     T            C PPPPPPPPPPPP   PPPP    T           g       |     |           p
PPPPPPPPPPPPPPPPPPPPPPPPPPPPPPPPPPPPPPPPPPPPPPP        PPPPPPPPPPPPPPPPPPPPPPPPPPPPPPPPPPPP^^^PPPPPPPPPPPPPPPPPPPPPPPPPPPPPPPPPPPPPPPPPPPPPPp
PPPPPPPPPPPPPPPPPPPPPPPPPPPPPPPPPPPPPPPPPPPPPPP        PPPPPPPPPPPPPPPPPPPPPPPPPPPPPPPPPPPPPPPPPPPPPPPPPPPPPPPPPPPPPPPPPPPPPPPPPPPPPPPPPPPPPp
PPPPPPPPPPPPPPPPPPPPPPPPPPPPPPPPPPPPPPPPPPPPPPP        PPPPPPPPPPPPPPPPPPPPPPPPPPPPPPPPPPPPPPPPPPPPPPPPPPPPPPPPPPPPPPPPPPPPPPPPPPPPPPPPPPPPPp
PPPPPPPPPPPPPPPPPPPPPPPPPPPPPPPPPPPPPPPPPPPPPPP     PPPPPPPPPPPPPPPPPPPPPPPPPPPPPPPPPPPPPPPPPPPPPPPPPPPPPPPPPPPPPPPPPPPPPPPPPPPPPPPPPPPPPPPPp